The Upper Floor
                                                     by 

                                          An Interactive Fiction

   Start the story - from the beginning    :    (SPACE)
                   - from a saved position :       R
   Quit                                    :       Q

>time
I didn't understand that sentence.

>exits
There are no obvious exits.

(Use EXITS ON to enable the status line exit lister and EXITS OFF to turn it off.)

>exits off
Exit listing is now off.

>exits on
Exit listing is now on.

* * *

The Upper Floor
                                                     by 

                                          An Interactive Fiction

   Start the story - from the beginning    :    (SPACE)
                   - from a saved position :       R
   Quit                                    :       Q

The Upper Floor
An Interactive Fiction
Release 1 / Serial number 201018 / Inform 7 build 6M62 (I6/v6.33 lib 6/12N) SD

Stage
You can see a sword, a cat, a cube, Bob, and an apple here.

>LOOK
Office