Liquids
An Interactive Fiction
Release 1 / Serial number 201117 / Inform 7 build 6M62 (I6/v6.33 lib 6/12N) SD

Kitchen
You can see the glass, the pot, the soda can, the oil vial, the water bottle and the milk jug here.

>get calculus
You can't see any such thing.

>east
You can't go that way.

>read book
You can't see any such thing.

>read page 2
You can't see any such thing.

>drop book
You can't see any such thing.

>w
You can't go that way.

>read page 5
You can't see any such thing.

>read page 1
You can't see any such thing.

>get book
You can't see any such thing.

>e
You can't go that way.

>read page 4
You can't see any such thing.

>read calculus page 4
You can't see any such thing.

* * *

Liquids
An Interactive Fiction
Release 1 / Serial number 201117 / Inform 7 build 6M62 (I6/v6.33 lib 6/12N) SD

Kitchen
You can see the glass, the pot, the soda can, the oil vial, the water bottle and the milk jug here.

>get water
Taken.

>drink water
You drink water from the water bottle.

>get oil
Taken.

>dump oil
You dump Oil from the oil vial onto the ground, where it's quickly absorbed.

>drink oil
The oil vial is empty. Nothing to drink in there.

* * *

Liquids
An Interactive Fiction
Release 1 / Serial number 201117 / Inform 7 build 6M62 (I6/v6.33 lib 6/12N) SD

Kitchen
You can see the glass, the pot, the soda can, the oil vial, the water bottle and the milk jug here.

>drink soda
You drink soda from the soda can.

>dump milk
You dump milk from the milk jug onto the ground, where it is quickly absorbed.

>pour water in pot
You pour water from the water bottle into the pot which now contains water.

>pour oil in pot
You pour oil from the oil vial into the pot which now contains oiled water.

>x pot
You see nothing special about the pot.

Inside the pot is oiled water.

>dip hand in pot
Your hand is now wet and oily.

* * *

>dump milk
You dump milk from the milk jug onto the ground, where it is quickly absorbed.

>dip hand in bottle
You dip your hand into water in the water bottle.

your hand won't fit in the water bottle.

>dip hand in oil
You dip your hand into oil in the oil vial.

your hand won't fit in the oil vial.

>pour water in pot
You pour some water from the water bottle into the pot which now contains some water.

>pour oil in pot
You pour some oil from the oil vial into the pot which now contains some oiled water.

>x pot
You see nothing special about the pot.

Inside the pot is oiled water.

>dip hand in pot
You dip your hand into oiled water in the pot.

Your hand is now wet and oily.

>pour pot on hand
You pour oiled water from the pot onto your hand.

Your hand is even more wet and oily now.