Music
An Interactive Fiction
Release 1 / Serial number 201027 / Inform 7 build 6M62 (I6/v6.33 lib 6/12N) SD

Listening Room
Music fills the air.

>s
Outdoors
Something sounds different here.

>start music
Music is now turned on.

* * *

>s
Outdoors
Something sounds different here.

>n
Listening Room
Music fills the air.

>music off
That's not a verb I recognise.

>stop music
Music is now turned off.

>s
Outdoors
Something sounds different here.

* * *

Music
An Interactive Fiction
Release 1 / Serial number 201027 / Inform 7 build 6M62 (I6/v6.33 lib 6/12N) SD

Listening Room
Music fills the air.

>stop music
Music is now turned off.

* * *

>s
Outdoors
Something sounds different here.

I beg your pardon?

>n
Listening Room
Music fills the air.

>s
Outdoors
Something sounds different here.

>sound on
That's not a verb I recognise.

>music on
That's not a verb I recognise.

>start music
Music is now turned on.

* * *

Music
An Interactive Fiction
Release 1 / Serial number 201027 / Inform 7 build 6M62 (I6/v6.33 lib 6/12N) SD

Listening Room
Music fills the air.

>music off
Music is now turned off.

>s
Outdoors
Something sounds different here.

>music on
Music is now turned on.

>exit
But you aren't in anything at the moment.

>quit
Are you sure you want to quit?

* * *

Music
An Interactive Fiction
Release 1 / Serial number 201027 / Inform 7 build 6M62 (I6/v6.33 lib 6/12N) SD

Listening Room
Music fills the air.

>e
Other Listening Room
Music continues to fill the air.

>exits
That's not a verb I recognise.

* * *

>e
Other Listening Room
Music continues to fill the air.

>w
Listening Room
Music fills the air.

>e
Other Listening Room
Music continues to fill the air.

* * *

>w
Listening Room
Music fills the air.

I beg your pardon?

>w
You can't go that way.

>e
Other Listening Room
Music continues to fill the air.

I beg your pardon?

>e
You can't go that way.

I beg your pardon?

* * *

>e
You can't go that way.

>w
Listening Room
Music fills the air.

>se
You can't go that way.

>s
Outdoors
Something sounds different here.

>ne
Other Listening Room
Music continues to fill the air.

>w
Listening Room
Music fills the air.

>quit
Are you sure you want to quit?