Purchasing Equipment
An Interactive Fiction
Release 1 / Serial number 201022 / Inform 7 build 6M62 (I6/v6.33 lib 6/12N) SD

Adventurers Shop
A shop for adventurers. The street is north.

You can see John, Susan, Thomas, and the countertop (on which are the sword, the shield, and the helmet) here.

>list
You see the following for sale:
  sword for 8 coins
  shield for 10 coins
  helmet for 4 coins

>ask thomas about sword
There is no reply.

>ask susan about sword
"That's not my the sword," it says. "You'll have to ask John."

>ask john about sword
He considers the sword. "That'll be 8 coins."

>get sword
Taken.

>get shield
Taken.

>wear shield
You put on the shield.

>get helmet
Taken.

>n
"Hey!" says John. "You can't leave. You still owe me 22 coins."

>inventory
You are carrying:
  the helmet (unpaid)
  the shield (unpaid) (being worn)
  the sword (unpaid)
  the coin purse (with 15 coins)
  a dagger

>pay for sword
You give 8 coins to John to pay for the sword.

>pay for shield
You don't have enough to pay for the shield.

>pay thomas
You should only pay shopkeepers.

>pay susan
You should probably pay the owner of the shop, John.

>pay john
You owe 14 coins but only have 7.

>pay for helmet
You give 4 coins to John to pay for the helmet.

>inventory
You are carrying:
  the helmet
  the shield (unpaid) (being worn)
  the sword
  the coin purse (with 3 coins)
  a dagger

>n
"Hey!" says John. "You can't leave. You still owe me 10 coins."

>drop unpaid
(first taking the shield off)
You drop the shield on the floor. With a grumble, John picks it up and replaces it on the countertop.

>n
Street
An empty cobblestone street. The shop is south.