Purchasing Equipment
An Interactive Fiction
Release 1 / Serial number 201114 / Inform 7 build 6M62 (I6/v6.33 lib 6/12N) SD

Adventurers Shop
A shop for adventurers. The street is north.

You can see John, Susan, Thomas, and the countertop (on which are the sword, the shield, and the helmet) here.

>list
You see the following for sale:
  sword for 8 coins
  shield for 10 coins
  helmet for 4 coins

>ask thomas about sword
There is no reply.

>ask susan about sword
"That's not my sword," she says. "You'll have to ask John."

>ask john about sword
He considers the sword. "That'll be 8 coins."

>get sword
Taken.

>get shield
Taken.

>wear shield
You put on the shield.

>get helmet
Taken.

>n
"Hey!" says John. "You can't leave. You still owe me 22 coins."

>inventory
You are carrying:
  the helmet (unpaid)
  the shield (unpaid) (being worn)
  the sword (unpaid)
  the purse
    fifteen coins
  a dagger

>pay for sword
"That'll be 8," John says. You should give you some coins.

>pay for shield
"That'll be 10," John says. You should give you some coins.

>pay thomas
You should only pay shopkeepers.

>pay susan
You should probably pay the owner of the shop, John.

>pay john
You owe 22 coins but only have 15.

>pay for helmet
"That'll be 4," John says. You should give you some coins.

>inventory
You are carrying:
  the helmet (unpaid)
  the shield (unpaid) (being worn)
  the sword (unpaid)
  the purse
    fifteen coins
  a dagger

>n
"Hey!" says John. "You can't leave. You still owe me 22 coins."

>drop unpaid
You drop the helmet on the floor. With a grumble, John picks it up and replaces it on the countertop.

You drop the sword on the floor. With a grumble, John picks it up and replaces it on the countertop.

(first taking the shield off)
You drop the shield on the floor. With a grumble, John picks it up and replaces it on the countertop.

>n
Street
An empty cobblestone street. The shop is south.

* * *

>pay for sword
"That'll be 8," John says. You should give you some coins.

>give 8 coins to john
You can't use multiple objects with that verb.

* * *

Purchasing Equipment
An Interactive Fiction
Release 1 / Serial number 201114 / Inform 7 build 6M62 (I6/v6.33 lib 6/12N) SD

Adventurers Shop
A shop for adventurers. The street is north.

You can see John, Susan, Thomas, and the countertop (on which are the sword, the shield, and the helmet) here.

>i
You are carrying:
  the purse
    fifteen coins
  a dagger

>give all to john
purse: You can't give multiple things at once, unless they are all coins.
dagger: You can't give multiple things at once, unless they are all coins.

>give 10 coins to john
coin: coin: coin: coin: coin: coin: coin: coin: coin: coin:

* * *

>i
You are carrying:
  the purse
    fifteen coins
  a dagger

>get coin
Taken.

>get coin
Taken.

>get coin
You don't have enough room left to carry the coin.

>get coin
You don't have enough room left to carry the coin.

I beg your pardon?

I beg your pardon?

>i
You are carrying:
  two coins
  the purse
    thirteen coins
  a dagger

>put coins in purse
coin: There is not enough room left in the purse for the coin.
coin: There is not enough room left in the purse for the coin.

* * *

Purchasing Equipment
An Interactive Fiction
Release 1 / Serial number 201114 / Inform 7 build 6M62 (I6/v6.33 lib 6/12N) SD

Adventurers Shop
A shop for adventurers. The street is north.

You can see John, Susan, Thomas, and the countertop (on which are the sword, the shield, and the helmet) here.

>give all to john
purse: dagger:

>give coin to john
(first taking the coin)
John doesn't seem interested.

>give 10 coins to john
coin: You give a coin to JohnYou give a coin to JohnYou give a coin to JohnYou give a coin to JohnYou give a coin to JohnYou give a coin to JohnYou give a coin to JohnYou give a coin to JohnYou give a coin to JohnYou give a coin to John
coin: You give a coin to JohnYou give a coin to JohnYou give a coin to JohnYou give a coin to JohnYou give a coin to JohnYou give a coin to JohnYou give a coin to JohnYou give a coin to JohnYou give a coin to JohnYou give a coin to John
coin: You give a coin to JohnYou give a coin to JohnYou give a coin to JohnYou give a coin to JohnYou give a coin to JohnYou give a coin to JohnYou give a coin to JohnYou give a coin to JohnYou give a coin to JohnYou give a coin to John
coin: You give a coin to JohnYou give a coin to JohnYou give a coin to JohnYou give a coin to JohnYou give a coin to JohnYou give a coin to JohnYou give a coin to JohnYou give a coin to JohnYou give a coin to JohnYou give a coin to John
coin: You give a coin to JohnYou give a coin to JohnYou give a coin to JohnYou give a coin to JohnYou give a coin to JohnYou give a coin to JohnYou give a coin to JohnYou give a coin to JohnYou give a coin to JohnYou give a coin to John
coin: You give a coin to JohnYou give a coin to JohnYou give a coin to JohnYou give a coin to JohnYou give a coin to JohnYou give a coin to JohnYou give a coin to JohnYou give a coin to JohnYou give a coin to JohnYou give a coin to John
coin: You give a coin to JohnYou give a coin to JohnYou give a coin to JohnYou give a coin to JohnYou give a coin to JohnYou give a coin to JohnYou give a coin to JohnYou give a coin to JohnYou give a coin to JohnYou give a coin to John
coin: You give a coin to JohnYou give a coin to JohnYou give a coin to JohnYou give a coin to JohnYou give a coin to JohnYou give a coin to JohnYou give a coin to JohnYou give a coin to JohnYou give a coin to JohnYou give a coin to John
coin: You give a coin to JohnYou give a coin to JohnYou give a coin to JohnYou give a coin to JohnYou give a coin to JohnYou give a coin to JohnYou give a coin to JohnYou give a coin to JohnYou give a coin to JohnYou give a coin to John
coin: You give a coin to JohnYou give a coin to JohnYou give a coin to JohnYou give a coin to JohnYou give a coin to JohnYou give a coin to JohnYou give a coin to JohnYou give a coin to JohnYou give a coin to JohnYou give a coin to John

* * *

>give coin to john
(first taking the coin)
John doesn't seem interested.

>give all coins to john
John doesn't seem interested.

>give 10 coins to john
coin: coin: coin: coin: coin: coin: coin: coin: coin: coin:

* * *

Purchasing Equipment
An Interactive Fiction
Release 1 / Serial number 201114 / Inform 7 build 6M62 (I6/v6.33 lib 6/12N) SD

Adventurers Shop
A shop for adventurers. The street is north.

You can see John, Susan, Thomas, and the countertop (on which are the sword, the shield, and the helmet) here.

>give 10 coins to john
coin: (first taking the coin)
John doesn't seem interested in your money.

You give the coin to John.

You give the coin to John.

coin: (first taking the coin)
John doesn't seem interested in your money.

You give the coin to John.

You give the coin to John.

coin: (first taking the coin)
John doesn't seem interested in your money.

You give the coin to John.

You give the coin to John.

coin: (first taking the coin)
John doesn't seem interested in your money.

You give the coin to John.

You give the coin to John.

coin: (first taking the coin)
John doesn't seem interested in your money.

You give the coin to John.

You give the coin to John.

coin: (first taking the coin)
John doesn't seem interested in your money.

You give the coin to John.

You give the coin to John.

coin: (first taking the coin)
John doesn't seem interested in your money.

You give the coin to John.

You give the coin to John.

coin: (first taking the coin)
John doesn't seem interested in your money.

You give the coin to John.

You give the coin to John.

coin: (first taking the coin)
John doesn't seem interested in your money.

You give the coin to John.

You give the coin to John.

coin: (first taking the coin)
John doesn't seem interested in your money.

You give the coin to John.

You give the coin to John.

>i
You are carrying:
  the purse
    five coins
  a dagger

* * *

Purchasing Equipment
An Interactive Fiction
Release 1 / Serial number 201114 / Inform 7 build 6M62 (I6/v6.33 lib 6/12N) SD

Adventurers Shop
A shop for adventurers. The street is north.

You can see John, Susan, Thomas, and the countertop (on which are the sword, the shield, and the helmet) here.

>give coin to john
(first taking the coin)
You give the coin to John.

You give the coin to John.

>rules
Rules tracing now switched on. Type "rules off" to switch it off again, or "rules all" to include even rules which do not apply.

>give coin to john
[Rule "Response Assistant reset responses list rule" applies.]
[Rule "declare everything initially unmentioned rule" applies.]
[Rule "announce items from multiple object lists rule" applies.]
[Rule "set pronouns from items from multiple object lists rule" applies.]
[Rule "before stage rule" applies.]
[Rule "keychain-aware carrying requirements rule" applies.]
[Rule "instead stage rule" applies.]
[Rule "investigate player's awareness before action rule" applies.]
[Rule "player aware of his own actions rule" applies.]
[Rule "check stage rule" applies.]
[Rule "can't give what you haven't got rule" applies.]
[Rule "can't give to yourself rule" applies.]
[Rule "can't give to a non-person rule" applies.]
[Rule "can't give clothes being worn rule" applies.]
[Rule "block giving rule" applies.]
John doesn't seem interested.

[Rule "A first turn sequence rule" applies.]
[Rule "every turn stage rule" applies.]
[Rule "reset protocol rule" applies.]
[Rule "Every turn" applies.]
[Rule "variable advance time rule" applies.]
[Rule "A last turn sequence rule" applies.]
[Rule "notify score changes rule" applies.]

* * *

>give coin to john
(first taking the coin)
You give the coin to John.

You give the coin to John.

>give 10 coins to john
coin: (first taking the coin)
That seems to belong to John.

coin: (first taking the coin)
You give the coin to John.

You give the coin to John.

coin: (first taking the coin)
You give the coin to John.

You give the coin to John.

coin: (first taking the coin)
You give the coin to John.

You give the coin to John.

coin: (first taking the coin)
You give the coin to John.

You give the coin to John.

coin: (first taking the coin)
You give the coin to John.

You give the coin to John.

coin: (first taking the coin)
You give the coin to John.

You give the coin to John.

coin: (first taking the coin)
You give the coin to John.

You give the coin to John.

coin: (first taking the coin)
You give the coin to John.

You give the coin to John.

coin: (first taking the coin)
You give the coin to John.

You give the coin to John.

* * *

Purchasing Equipment
An Interactive Fiction
Release 1 / Serial number 201114 / Inform 7 build 6M62 (I6/v6.33 lib 6/12N) SD

Adventurers Shop
A shop for adventurers. The street is north.

You can see John, Susan, Thomas, and the countertop (on which are the sword, the shield, and the helmet) here.

>n
Street
An empty cobblestone street. The shop is south.

>drop purse
You can't see any such thing.

>s
Adventurers Shop
A shop for adventurers. The street is north.

You can see John, Susan, Thomas, and the countertop (on which are the sword, the shield, and the helmet) here.

>i
You are carrying:
  a dagger

* * *

Purchasing Equipment
An Interactive Fiction
Release 1 / Serial number 201114 / Inform 7 build 6M62 (I6/v6.33 lib 6/12N) SD

Adventurers Shop
A shop for adventurers. The street is north.

You can see John, Susan, Thomas, and the countertop (on which are the sword, the shield, and the helmet) here.

>get coin
Taken.

>put coin in purse
You put the coin into the purse.

>i
You are carrying:
  the purse
    fifteen coins
  a dagger

>give 10 coins to john
coin: (first taking the coin)
You give the coin to John.

coin: (first taking the coin)
You give the coin to John.

coin: (first taking the coin)
You give the coin to John.

coin: (first taking the coin)
You give the coin to John.

coin: (first taking the coin)
You give the coin to John.

coin: (first taking the coin)
You give the coin to John.

coin: (first taking the coin)
You give the coin to John.

coin: (first taking the coin)
You give the coin to John.

coin: (first taking the coin)
You give the coin to John.

coin: (first taking the coin)
You give the coin to John.

* * *

Purchasing Equipment
An Interactive Fiction
Release 1 / Serial number 201114 / Inform 7 build 6M62 (I6/v6.33 lib 6/12N) SD

Adventurers Shop
A shop for adventurers. The street is north.

You can see John, Susan, Thomas, and the countertop (on which are the sword, the shield, and the helmet) here.

>give 10 coins to susan
coin: (first taking the coin)
They don't seem interested in your money.

coin: (first taking the coin)
They don't seem interested in your money.

coin: (first taking the coin)
You don't have enough room left to carry the coin.

coin: (first taking the coin)
You don't have enough room left to carry the coin.

coin: (first taking the coin)
You don't have enough room left to carry the coin.

coin: (first taking the coin)
You don't have enough room left to carry the coin.

coin: (first taking the coin)
You don't have enough room left to carry the coin.

coin: (first taking the coin)
You don't have enough room left to carry the coin.

coin: (first taking the coin)
You don't have enough room left to carry the coin.

coin: (first taking the coin)
You don't have enough room left to carry the coin.

>showme susan
Susan - shopkeeper
    coin - coin
    coin - coin
    coin - coin
    coin - coin
    coin - coin
    coin - coin
    coin - coin
    coin - coin
    coin - coin
    coin - coin
location: in the Adventurers Shop
singular-named, proper-named, without description; unlit, inedible, portable, seen, familiar, paid; female; list grouping key: none
printed name: "Susan"
printed plural name: "shopkeepers"
indefinite article: none
description: none
initial appearance: none
bulk: 5
coin cost: 0
carrying capacity: 100
bulk capacity: 100
bribe amount: 0
posture: standing
expected payment: 0

>showme john
John - shopkeeper
location: in the Adventurers Shop
singular-named, proper-named, without description; unlit, inedible, portable, seen, familiar, paid; male; list grouping key: none
printed name: "John"
printed plural name: "shopkeepers"
indefinite article: none
description: none
initial appearance: none
bulk: 5
coin cost: 0
carrying capacity: 100
bulk capacity: 100
bribe amount: 0
posture: standing
expected payment: 0

* * *

>showme susan
Susan - shopkeeper
    coin - coin
    coin - coin
    coin - coin
    coin - coin
    coin - coin
    coin - coin
    coin - coin
    coin - coin
    coin - coin
    coin - coin
location: in the Adventurers Shop
singular-named, proper-named, without description; unlit, inedible, portable, seen, familiar, paid; female; list grouping key: none
printed name: "Susan"
printed plural name: "shopkeepers"
indefinite article: none
description: none
initial appearance: none
bulk: 5
coin cost: 0
carrying capacity: 100
bulk capacity: 100
bribe amount: 0
posture: standing
expected payment: 0

>showme here
There seems to be no such object anywhere in the model world.

>l
Adventurers Shop
A shop for adventurers. The street is north.

You can see John, Susan, Thomas, and the countertop (on which are the sword, the shield, and the helmet) here.

>showme adventurers shope
I only understood you as far as wanting to showme the Adventurers Shop.

>showme adventurers shop
Adventurers Shop - shop
    yourself - person
        purse - open container
            coin - coin
            coin - coin
            coin - coin
            coin - coin
            coin - coin
        dagger
    John - shopkeeper
    Susan - shopkeeper
        coin - coin
        coin - coin
        coin - coin
        coin - coin
        coin - coin
        coin - coin
        coin - coin
        coin - coin
        coin - coin
        coin - coin
    Thomas - man
    countertop - supporter
        sword
        shield
        helmet
singular-named, improper-named; lighted, visited, apparent, posture-friendly
list grouping key: none
printed name: "Adventurers Shop"
printed plural name: none
indefinite article: none
description: "A shop for adventurers. The street is north."
destination name: none
owner: John

* * *

>give 10 coins to john
coin: They don't seem interested in your money.

coin: They don't seem interested in your money.

coin: (first taking the coin)
You don't have enough room left to carry the coin.

coin: (first taking the coin)
You don't have enough room left to carry the coin.

coin: (first taking the coin)
You don't have enough room left to carry the coin.

coin: (first taking the coin)
You don't have enough room left to carry the coin.

coin: (first taking the coin)
You don't have enough room left to carry the coin.

coin: (first taking the coin)
You don't have enough room left to carry the coin.

coin: (first taking the coin)
You don't have enough room left to carry the coin.

coin: (first taking the coin)
You don't have enough room left to carry the coin.

* * *

Purchasing Equipment
An Interactive Fiction
Release 1 / Serial number 201114 / Inform 7 build 6M62 (I6/v6.33 lib 6/12N) SD

Adventurers Shop
A shop for adventurers. The street is north.

You can see John, Susan, Thomas, and the countertop (on which are the sword, the shield, and the helmet) here.

>give 10 coins to thomas
coin: (first taking the coin)
They don't seem interested in your money.

coin: (first taking the coin)
They don't seem interested in your money.

coin: (first taking the coin)
You don't have enough room left to carry the coin.

coin: (first taking the coin)
You don't have enough room left to carry the coin.

coin: (first taking the coin)
You don't have enough room left to carry the coin.

coin: (first taking the coin)
You don't have enough room left to carry the coin.

coin: (first taking the coin)
You don't have enough room left to carry the coin.

coin: (first taking the coin)
You don't have enough room left to carry the coin.

coin: (first taking the coin)
You don't have enough room left to carry the coin.

coin: (first taking the coin)
You don't have enough room left to carry the coin.

>give coin to john
They don't seem interested in your money.

>l
Adventurers Shop
A shop for adventurers. The street is north.

You can see John, Susan, Thomas, and the countertop (on which are the sword, the shield, and the helmet) here.

>get sword
You don't have enough room left to carry the sword.

>i
You are carrying:
  two coins
  the purse
    thirteen coins
  a dagger

>put coins in purse
coin: Done.
coin: Done.

>get sword
Taken.

>give 10 coins to john
coin: (first taking the coin)
They don't seem interested in your money.

coin: (first taking the coin)
You don't have enough room left to carry the coin.

coin: (first taking the coin)
You don't have enough room left to carry the coin.

coin: (first taking the coin)
You don't have enough room left to carry the coin.

coin: (first taking the coin)
You don't have enough room left to carry the coin.

coin: (first taking the coin)
You don't have enough room left to carry the coin.

coin: (first taking the coin)
You don't have enough room left to carry the coin.

coin: (first taking the coin)
You don't have enough room left to carry the coin.

coin: (first taking the coin)
You don't have enough room left to carry the coin.

coin: (first taking the coin)
You don't have enough room left to carry the coin.

>n
"Hey!" says John. "You can't leave. You still owe me 8 coins."

>give 8 coins to john
coin: They don't seem interested in your money.

coin: (first taking the coin)
You don't have enough room left to carry the coin.

coin: (first taking the coin)
You don't have enough room left to carry the coin.

coin: (first taking the coin)
You don't have enough room left to carry the coin.

coin: (first taking the coin)
You don't have enough room left to carry the coin.

coin: (first taking the coin)
You don't have enough room left to carry the coin.

coin: (first taking the coin)
You don't have enough room left to carry the coin.

coin: (first taking the coin)
You don't have enough room left to carry the coin.

* * *

Purchasing Equipment
An Interactive Fiction
Release 1 / Serial number 201114 / Inform 7 build 6M62 (I6/v6.33 lib 6/12N) SD

Adventurers Shop
A shop for adventurers. The street is north.

You can see John, Susan, Thomas, and the countertop (on which are the sword, the shield, and the helmet) here.

>get sword
Taken.

>give 8 coins to john
coin: (first taking the coin)
You give the coin to John.

coin: (first taking the coin)
You give the coin to John.

coin: (first taking the coin)
You give the coin to John.

coin: (first taking the coin)
You give the coin to John.

coin: (first taking the coin)
You give the coin to John.

coin: (first taking the coin)
You give the coin to John.

coin: (first taking the coin)
You give the coin to John.

coin: (first taking the coin)
You give the coin to John.

>m
I didn't understand that sentence.

>n
"Hey!" says John. "You can't leave. You still owe me 8 coins."

* * *

>get sword
Taken.

>get helmet
"Oy!" John says. "Pay for what you have first."

>pay for helmet
You don't have enough to pay for the helmet.

>i
You are carrying:
  the sword (unpaid)
  the purse
    fifteen coins
  a dagger

>ask john about helmet
He considers the helmet. "That'll be 4 coins."

* * *

Purchasing Equipment
An Interactive Fiction
Release 1 / Serial number 201114 / Inform 7 build 6M62 (I6/v6.33 lib 6/12N) SD

Adventurers Shop
A shop for adventurers. The street is north.

You can see John, Susan, Thomas, and the countertop (on which are the sword, the shield, and the helmet) here.

>put bar in foo
You put bar into foo.

>put fo in shebang
You can't see any such thing.

>i
You are carrying:
  foo
    bar
  shebang
  the purse
    fifteen coins
  a dagger

>put foo in shebang
You put foo into shebang.

>i
You are carrying:
  shebang
    foo
      bar
  the purse
    fifteen coins
  a dagger

* * *

Purchasing Equipment
An Interactive Fiction
Release 1 / Serial number 201114 / Inform 7 build 6M62 (I6/v6.33 lib 6/12N) SD

Adventurers Shop
A shop for adventurers. The street is north.

You can see John, Susan, Thomas, and the countertop (on which are the sword, the shield, and the helmet) here.

>get helmet
Taken.

* * *

>pay for helmet
"That'll be 4," John says. You should give you some coins.

* * *

>get helmet
Taken.

>give 4 coins to john
coin: (first taking the coin)
You give the coin to John.

coin: (first taking the coin)
You give the coin to John.

coin: (first taking the coin)
You give the coin to John.

coin: (first taking the coin)
You give the coin to John.

>get sword
"Oy!" John says. "Pay for what you have first."

* * *

Purchasing Equipment
An Interactive Fiction
Release 1 / Serial number 201114 / Inform 7 build 6M62 (I6/v6.33 lib 6/12N) SD

Adventurers Shop
A shop for adventurers. The street is north.

You can see John, Susan, Thomas, and the countertop (on which are the sword, the shield, and the helmet) here.

>buy helmet
Use PAY FOR helmet.

>pay for helmet
"That'll be 4 coins," John says. You should give you some coins.

>give john 4 coins
I didn't understand that sentence.

>give 4 coins to john
coin: (first taking the coin)
It isn't interested in your money.

coin: (first taking the coin)
It isn't interested in your money.

coin: (first taking the coin)
You don't have enough room left to carry the coin.

coin: (first taking the coin)
You don't have enough room left to carry the coin.

>get helmet
You don't have enough room left to carry the helmet.

>put coins in purse
coin: Done.
coin: Done.

>get helmet
Taken.

>give 4 coins to john
coin: (first taking the coin)
"Oy!" John says. "Pay for what you have first."

coin: (first taking the coin)
"Oy!" John says. "Pay for what you have first."

coin: (first taking the coin)
"Oy!" John says. "Pay for what you have first."

coin: (first taking the coin)
"Oy!" John says. "Pay for what you have first."